AttritionBountyExt=宰杀敌人
AttritionBountyCap=捕获他们的领袖
AssassinateBountyCap=捕获新任Grineer指挥官
CaptureBountyCapOne=捕获Grineer的指挥官
AttritionBountyLib=削弱Grineer的据点
SabotageBountySab=破坏原型机
ReclamationBountyCache=找出遗失的器物
AttritionBountySab=破坏Grineer的补给线
AssassinateBountyAss=刺杀指挥官
RescueBountyResc=搜索并救援
ReclamationBountyTheft=取回被偷的器物
CaptureBountyCapTwo=间谍捕手
ReclamationBountyCap=捕获Grineer特工
AttritionBountyExt=宰杀敌人
TierATableARewards=铜：蓄能重划(MOD)|奥金*300|伊莱体*15|现金*1500|50内融核心\n银：GARA机体 蓝图|抵近射击(MOD)|简化(MOD)\n金：非晶态合金*2
TierATableBRewards=铜：压迫点(MOD)|永冻晶矿*100|现金*1500|50内融核心|葛克度*15\n银：GARA 机体 蓝图|黄蜂蜇刺(MOD)|延伸(MOD)\n金：非晶态合金*2
TierATableCRewards=铜：生命力(MOD)|生物质*200|1500现金|50内融核心|尼蒐荚*15\n银：GARA机体 蓝图|抵近射击(MOD)|聚精会神(MOD)\n金：稼*2
TierBTableARewards=铜：钢铁纤维(MOD)|奥金*200|2500现金|100内融核心|古纪T1遗物|\n银：GARA 系统 蓝图|蓄力装填(MOD)|炙热黄蜂(MOD)\n金：控制模块*2
TierBTableBRewards=铜：能量转化(MOD)|永冻晶矿*200|2500现金|100内融核心|古纪B2遗物\n银：GARA系统 蓝图|灵敏扳机(MOD)|收割螺旋(MOD)\n金：神经传感器*2
TierBTableCRewards=铜：致命一击(MOD)|电路*300|希图斯幽魂|2500现金匣|100内融核心\n银：GARA系统 蓝图|耐久强化(MOD)|冷面狂怒(MOD)\n金：OROKIN电池*2
TierCTableARewards=铜：角斗士 圣盾(MOD)|MADURAI晶体|希图斯幽魂|200内融核心|前纪N5遗物\n银：GARA头部神经元 蓝图|预言 协约(MOD)|飞光荒疫(MOD)\n金：私法 补给(MOD)
TierCTableBRewards=铜：私法 军备(MOD)|VAZARIN晶体|UNAIRU晶体|200内融核心|前纪K1遗物|\n银：GARA头部神经光元 蓝图|角斗士 威猛(MOD)|破碎之风(MOD)|\n金：预言 探求(MOD)
TierCTableCRewards=铜：预言 契约(MOD)|NARAMON晶体|ZENURIK晶体|200内融核心|前纪G1遗物\n银：GARA头部神经光元 蓝图|私法 热诚(MOD)|旋风虎击(MOD)\n金：角斗士 钳制(MOD)
TierDTableARewards=铜：角斗士 猛突(MOD)|UNAIRU晶体|MADURAL晶体|300内融核心\n银：希图斯幽魂|预言 通灵(MOD)|终焉风暴(MOD)|中级K1遗物\n金：私法 侵犯
TierDTableBRewards=铜：私法 活力|ZENURIK晶体|VAZARIN晶体|300内融核心|中纪M1遗物\n银：希图斯幽魂|角斗士 决心|纵横双子\n金：预言 神密
TierDTableCRewards=铜：预言 启示(MOD)|赤毒*100|NARAMON晶体|300内融核心|中纪H1遗物\n银：希图斯幽魂|私法 追踪(MOD)|沉没之爪(MOD)\n金：角斗士 灵巧(MOD)
TierETableARewards=铜：夜灵之息*5|后纪V7遗物\n银：希图斯幽魂*2|赤毒*300\n金：弗拉克斯亡魂 左拳套|雕斩螳螂(MOD)|夜灵晶体 蓝图
TierETableBRewards=铜：夜灵之息*5|400内融核心\n银：希图斯幽魂*2|赤毒*300|后纪O2遗物\n金：弗拉克斯亡魂 右拳套|猎鹰俯击(MOD)|夜灵晶体 蓝图
TierETableCRewards=铜：夜灵之息*5|后记V6遗物\n银：希图斯幽魂*2|赤毒*300\n金：弗拉克斯亡魂 蓝图|回转尖峰(MOD)|夜灵晶体 蓝图
MT_EXCAVATE=挖掘
MT_DEFENSE=防御
MT_MOBILE_DEFENSE=移动防御
MT_RESCUE=救援
MT_SURVIVAL=生存
MT_EXTERMINATION=歼灭
MT_TERRITORY=拦截
MT_SABOTAGE=破坏
MT_INTEL=间谍
MT_CAPTURE=捕获
MT_RETRIEVAL=劫持
MT_HIVE=清巢
MT_ASSASSINATION=刺杀
MT_ASSAULT=强袭
MT_EVACUATION=叛逃
MT_LANDSCAPE=自由漫步
SORTIE_MODIFIER_BOW_ONLY=弓箭 限定
SORTIE_MODIFIER_SECONDARY_ONLY=次要 限定
SORTIE_MODIFIER_ARMOR=敌人护甲强化
SORTIE_MODIFIER_EXIMUS=卓越者
SORTIE_MODIFIER_MAGNETIC=敌人元素抗性强化(磁性)
SORTIE_MODIFIER_FREEZE=敌人元素抗性强化(冰冻)
SORTIE_MODIFIER_IMPACT=敌人物理抗性强化(冲击)
SORTIE_MODIFIER_PUNCTURE=敌人物理抗性强化(穿刺)
SORTIE_MODIFIER_LOW_ENERGY=能力上限减少
SORTIE_MODIFIER_HAZARD_RADIATION=辐射伤害
SORTIE_MODIFIER_HAZARD_MAGNETIC=电磁异常
SORTIE_MODIFIER_HAZARD_ICE=低温外泄
SORTIE_MODIFIER_RIFLE_ONLY=突击步枪 限定
SORTIE_MODIFIER_SHOTGUN_ONLY=霰弹枪 限定
SORTIE_MODIFIER_SHIELDS=敌人护盾强化
SORTIE_MODIFIER_SLASH=敌人物理抗性强化(切割)
SORTIE_MODIFIER_HAZARD_FIRE=火灾
SORTIE_MODIFIER_EXPLOSION=敌人元素抗性强化(爆炸)
SORTIE_MODIFIER_ELECTRICITY=敌人元素抗性强化(电击)
SORTIE_MODIFIER_MELEE_ONLY=近战 限定
SORTIE_MODIFIER_CORROSIVE=敌人元素抗性强化(腐蚀)
SORTIE_MODIFIER_VIRAL=敌人元素抗性强化(病毒)
SORTIE_MODIFIER_POISON=敌人元素抗性强化(毒素)
SORTIE_MODIFIER_FIRE=敌人元素抗性强化(火焰)
SORTIE_MODIFIER_SNIPER_ONLY=狙击枪 限定
SORTIE_MODIFIER_HAZARD_COLD=极度寒冷
SORTIE_MODIFIER_HAZARD_FOG=浓雾
SORTIE_MODIFIER_RADIATION=敌人元素抗性强化(辐射)
SORTIE_BOSS_AMBULAS=击败 Ambulas 的部队(Corpus)
SORTIE_BOSS_KELA=击败 Kela De Thaym 的部队(Grineer)
SORTIE_BOSS_HYENA=击败 鬣狗群 的部队(Corpus)
SORTIE_BOSS_RAPTOR=击败 猛禽 的部队(Corpus)
SORTIE_BOSS_VOR=击败 Vor 上尉 的部队(Grineer)
SORTIE_BOSS_JACKAL=击败 豺狼 的部队(Corpus)
SORTIE_BOSS_PHORID=击败 Phorid 的部队(Infestation)
SORTIE_BOSS_TYL=击败 Tyl Regor 的部队(Grineer)
SORTIE_BOSS_NEF=击败 Nef Anyo 的部队(Corpus)
SORTIE_BOSS_KRIL=击败 Lech Kril 中尉的部队(Grineer)
SORTIE_BOSS_ALAD=击败 Alad V 的部队(Corpus)
SORTIE_BOSS_RUK=击败 Sargas Ruk 将军的部队(Grineer)
SORTIE_BOSS_LEPHANTIS=击败 Lephantis 的部队(Infested)
SORTIE_BOSS_INFALAD=击败 异融者 ALAD V 的部队(Infested)
SORTIE_BOSS_HEK=击败 Vay Hek 委员的部队(Grineer)
SORTIE_BOSS_CORRUPTED_VOR=击败 VOR上尉的部队(Corpus)
FC_OROKIN=虚空
FC_INFESTATION=Infestation
FC_GRINEER=Grineer
FC_CORPUS=Corpus
Helmet=头盔
Blueprint=蓝图
Systems=系统
Receiver=枪机
Stock=枪托
Barrel=枪管
Chassis=机体
OrokinCell=OROKIN 电池
OrokinCatalyst=OROKIN 催化剂
OrokinReactorBlueprint=OROKIN 催化剂 蓝图
OrokinReactor=OROKIN 反应堆
OrokinReactorBlueprint=OROKIN 反应堆 蓝图
AlloyPlate=合金板
Salvage=回收金属
Plastids=生物质
Ferrite=铁氧体
Morphic=非晶态合金
PolymerBundle=聚合物束
Neurode=神经元
Circuits=电路
Rubedo=红化结晶
Gallium=镓
Tellurium=碲
NeuralSensor=神经传感器
OxiumAlloy=奥席金属
Nanospores=纳米孢子
Alertium=泥炭萃取物
ControlModule=控制模块
VoidTearDrop=虚空光体
BioComponent=突变原聚合物
EnergyComponent=电磁力场装置
ChemComponent=爆燃喷射器
ArgonCrystal=氩结晶
KubrowEgg=狗蛋
AuraMod=(光环Mod)
PlayerPistolAmmo=手枪弹药搜集者
PlayerHealthRegen=返老还童
PlayerHealth=体魄
PlayerEnemyRadar=侦敌雷达
EnemyShieldReduction=护盾瓦解
InfestationSpeedReduction=感染者阻抗
PlayerRifleAmmo=步枪弹药搜集者
RobotPoorAim=电磁脉冲场
PlayerLootRadar=战利品探测器
WildfireMod=野火
EnemyArmorReduction=腐蚀投射
FocusEnergyMod=聚焦能量
HammerShotMod=重锤射击
SentinelLootRadarEnemyRadarMod=动物本能
ReloadSpeedPunchThroughMod=狂暴追猎
BlazeMod=烈焰
RendingStrikeMod=撕裂打击
RunSpeedArmorMod=灵活装甲
PlayerMelee=钢铁充能
GrinderMod=致命洪流
FortitudeMod=不屈不挠
StunningSpeedMod=摄人神速
ShredMod=撕裂
VigorMod=活力
UncommonFusionBundle=50融合点数
RareFusionBundle=80融合点数
NightwatchFusionBundle=800融合点数
MarketTier3FusionBundle=1000融合点数
MarketTier2FusionBundle=400融合点数
MarketTier1FusionBundle=100融合点数
CommonFusionBundle=15融合点数
AlertRewardFusionBundle=235融合点数
AlertFusionBundleSmall=80融合点数
AlertFusionBundleMedium=100融合点数
AlertFusionBundleLarge=150融合点数
Trapper=VAUBAN
Link=连接器
Wraith=亡魂
Vandal=破坏者
Latron=拉特昂
Snipetron=狙击特昂
TwinVipers=双子蝰蛇
DarkSword=暗黑长剑
DarkDagger=暗黑匕首
CeramicDagger=陶瓷匕首
HeatDagger=烈焰短剑
PangolinSword=鲮鲤剑
StatlessVoltAlt=VOLT 风暴
RangerAltB=IVARA 头罩
LimboAltB=LIMBO 画家
StatlessV2RhinoAlt=RHINO 先锋
GrnHammer=布洛克外观 重击巨锤 
WukongAlt=WUKONG 大圣
FairyAlt=Titania 风之妖精
StatlessTrinityAlt=TRINITY 预言
StatlessV2VoltAlt=VOLT 脉冲
StatlessNyxAlt=NYX 灭神
OberonAltB=OBERON 捻角山羊
OberonAlt=OBERON 羚羊
ExcaliburMordred=EXCALIBUR 莫德雷
AnimaAlt=EQUINOX 至点
Karak=卡拉克
Dera=德拉
Strun=斯特朗
ValkyrBastet=VALKYR 芭丝特
InfestedAladCoordinate=异融 ALAD V 导航坐标
StatlessRhinoAlt=RHINO 震击
PirateAltB=HYDROID 海怪
StatlessSarynAlt=SARYN 铁杉
StatlessBansheeAlt=BANSHEE 返响
StatlessV2AshAlt=ASH 飞蝗
StatlessLokiAlt=LOKI 本质
ZephyrCierzo头=ZEPHYR 西熟风
NekrosShroud=NEKROS 裹尸布
CowgirlAlt=MESA 长角
StatlessExcaliburAlt=EXCALIBUR 阿瓦隆
StatlessV2EmberAlt=EMBER 复燃
StatlessFrostAlt=FROST 极光
LimboAristeas=LIMBO 诗人
ValkyrAltB=VALKYR 狂者
GrnAxe=蝎尾狮重斧(皮肤)
StatlessAshAlt=ASH 毒蝎
NovaQuantum=NOVA 量子
StatlessEmberAlt=EMBER 凤凰
MirageAltB=MIRAGE 丑仆
StatlessNovaAlt=NOVA 通量
SandmanAlt=INAROS 阿努比斯
DualDaggerAxe=佐伦双斧 戈刃外观
NekrosAraknid=NEKROS 古墓
PlasmaSword=等离子长剑
HeatSword=烈焰长剑
DaggerAxe=戈刃外观 分裂斩斧
DragonAlt=CHROMA 龙蛇
RangerAlt=IVARA 洛克斯利
StatlessVaubanAlt=VAUBAN 机敏
Jaw=蛇颚刀
PlayerSprint=冲刺提升
IceStormMod=冰风暴
StatlessV2TrinityAlt=TRINITY 经络
GrineerCombatKinfeSortie=希芙
GrineerCombatKnifeSortie=希芙
StatlessV2FrostAlt=FROST 飑风
ConstitutionMod=百折不挠
PlayerRifleDamage=步枪增幅
CatbrowGennticSignatu=库娃遗传密码
CatbrowGennticSignature=库娃遗传密码
CatbrowGeneticSignature=库娃遗传密码
StatlessV2BansheeAlt=BANSHEE 合音
PlayerHolsterSpeed=快速切换
Glaive=战刃
NidusAlt=NIDUS 朊毒
StatlessV2ExcaliburAlt=EXCALIBUR 潘德拉冈
StatlessV2MagAlt=MAG 高斯
NovaSlipstream=NOVA 气流
MesaAltB=MESA 羊角
StatlessV2VaubanAlt=VAUBAN 策略
UtilityUnlocker=特殊功能槽连接器
LokiEnigma=LOKI 谜样
PlayerSniperAmmo=狙击枪弹药搜集者
NezhaAlt=NEZHA 奇尔卡
StatlessV2SarynAlt=SARYN 氯毒
PlayerSniperDamage=死亡之眼
BrawlerAlt=ATLAS 炼狱
卡拉克亡魂=亡魂卡拉克
StatlessV2NyxAlt=NYX 黄蜂
StatlessV2LokiAlt=LOKI 欺诈
BrawlerAltTwo=ATLAS 兜围
ChromaAltB=CHROMA 羽蛇神
PlayerEnergyRegen=能量虹吸
StatlessMagAlt=MAG 线圈
Vauban头盔Soldier=VAUBAN 休战
AcceleratedBlastMod=加速冲击
Eventium=合成刺激质
GrineerCombatKnifeHilt=希芙 握柄
GrineerCombatKnifeBlade=希芙 刀刃
PirateAlt=HYDROID 海之信使
阿努比斯B=卡诺匹斯
PlayerShellAmmo=霰弹枪弹药搜集者
BardAlt=OCTAVIA 华彩乐章
PriestAlt=Harrow 副主教
MonkeyKingAltB=WUKONG 猕猴
HarlequinAlt=MIRAGE 丑角
炼狱Two=兜围
GrineerCombatKnifeHeatsink=希芙 散热片
PlayerMeleeWeaponRandomModRare=近战裂罅
StrikerAcolyteAgent=焦虑
HeavyAcolyteAgent=怨恨
CeramicDaggerBlueprint=陶瓷匕首蓝图
PriestAltHelmetBlueprint=Harrow 副主教头盔蓝图
FormaBlueprint=Forma蓝图
TwinVipersWraithReceiver=双子蝰蛇亡魂枪击
DeraVandalBlueprint=德拉破坏者蓝图
SnipetronVandalBarrel=狙击特昂破坏者枪管
StrunWraithReceiver=亡魂斯特朗枪击
DaggerAxeBlueprint=佐伦双斧
PlayerMeleeAuraMod=钢铁充能
PlasmaSwordBlueprint=等离子长剑
StatlessV2NyxAltHelmetBlueprint=NYX 黄蜂头盔 蓝图
SnipetronVandalReceiver=狙击特昂破坏者枪机
KarakWraithStock=卡拉克亡魂枪托
DualDaggerAxeBlueprint=佐伦双斧 戈刃外观 蓝图
GlaiveBlueprint=战刃 蓝图
GlassAltHelmetBlueprint=Gara悍妇头盔 蓝图
NovaSlipstreamHelmetBlueprint=Nova气流头盔 蓝图
UtilityUnlockerBlueprint=特殊功能槽连接器 蓝图
TwinVipersWraithLink=双子蝰蛇 亡魂 连接器
DeraVandalStock=德拉 破坏者 枪托
JawBlueprint=蛇颚刀 蓝图
KarakWraithBarrel=卡拉克 亡魂 枪管
DeraVandalReceiver=德拉 破坏者 枪机
NovaQuantumHelmetBlueprint=NOVA量子头盔 蓝图
ZephyrTenguHelmetBlueprint=Zephyr天狗头盔